1111111111111111111
1000000000000000001
1000000040000000001
1000003340330000001
1000003300330000001
1000000222000000001
1000000222000000001
1000000222000000001
1000000222000000001
1000000222000000001
1000000000000000001
1111111111111111111
