1111111111111111111
1000000000000000001
1002200000000022001
1002200000000022001
1000000000000000001
1000000000000000001
1002200000000022001
1002200000000022001
1000000022200000001
1000000022200000001
1000000000000000001
1111111111111111111
